10 10
0 0
9 9
S......c..
....##....
....##....
c...##...c
....##....
..........
....##....
c...##...c
....##....
....##...G
