15 15
0 0
14 14
S........#....c
.#.###.#..###..
.#.....#......#
.#.###.#.####.#
...c.#....#....
###.###.###.###
....c.....c....
.###.####.####.
.....#....#....
c###.#.####.#c.
.....#....#....
.###.####.####.
.......c.......
.####.####.####
c............cG
